R 1980 1080

NO ./colorstone.xpm   
SO ./greystone.xpm    
WE ./bluestone.xpm  
EA ./mossy.xpm  

S ./barrel.xpm   
F 0,255,25
C 0,0,225

        1111111111111111111111111
        1000000000110000200000001
        1011000001110000000000001
        100100000000000N002000001
111111111011000001110000000000001
100000000011000001111110111111111
111101111111110111000000100011111
111101111111110111010100100001111
110000001101010111000000100011111
100000000000000011000000000000001
100000000000000000010100100011111
110000011101010111110111100011111
11110111 1111101 101111010001
11111111 1111111 111111111111